_X___GX___
_X_XXXX___
______X___
XXXX____X_
___X__S_X_
X_________