_____GX_
____XXX_
________
XXXX____
___X____
S_______